ABU: Argentina, Brazil and Uruguay; Argentina, Brazil, and Uruguay
African Group: Africa Group, African States, AFRICA GROUP
AILAC: Independent Alliance of Latin America and the Caribbean, Independent Association of Latin America and the Caribbean
ALBA: Bolivarian Alliance for the Peoples of our America, Bolivarian Alliance for the Peoples of Our America
AOSIS: Alliance of Small Island States
APEC: Asia Pacific Economic Cooperation
Arab Group: Arabian Countries Group
BASIC: Brazil, South Africa, India and China; Brazil, South Africa, India, and China; BASIC (Brazil, South Africa, India and China); BASIC (Brazil, South Africa, India, and China); BASIC group (Brazil, South Africa, India and China)
CACAM: Albania and Moldova, Albania and Moldova Group, CAC&M, CACAM group
CARICOM: Caribbean Community, CARICOM states
Cartagena Dialogue
Central American Group: Central American States, Central America
Central Group: CENTRAL GROUP 11, Central Group of Eleven (CG-11), Central Group Eleven
CfRN: Coalition for Rainforest Nations, Coalition of Rainforest Nations, COALITION OF RAINFOREST NATIONS, COALITION FOR RAINFOREST NATIONS
CG-11: Central Group Eleven, Central Group 11
Climate Alliance
Climate Group
COMIFAC: Central Africa Forests Commission, Central Africa Forests Commission (COMIFAC), Central Africa Forestry Commission
Congo Basin Countries
CVF: Climate Vulnerable Forum
EIG: Environmental Integrity Group; ENVIRONMENTAL INTEGRITY GROUP; Environmental Integrity Group (Switzerland, Republic of Korea and Mexico); Environmental Integrity Group (a coalition of countries including Switzerland, Mexico and the Republic of Korea); Environmental Integrity Group (a recently formed negotiating group comprising Switzerland, Mexico and the Republic of Korea); Environmental Integrity Group (Switzerland, Mexico, Republic of Korea, Monaco and Liechtenstein)
EIT: Economies in Transition, EITs, economies in transition, Economies in transition
EU: European Union, EUhighlighted
G-77/China: G77, G-77, G-77 and China, G-77/ China, G-77/ CHINA, G-77/China, G77 and China, G77-China, G77/China, Group of 77 and China, Group of 77
Group of Nine: Group of 9
GRULAC: Group of Latin American and Caribbean Countries, Group of Latin American and Caribbean Countries (GRULAC), Group of Latin American and Caribbean countries, Latin American and Caribbean Group‚Äù
HAC: High Ambition Coalition
Indigenous Caucus
JUSCANZ
LDCs: Least Developed Countries, LDC Group, LDC GROUP, Least Developed Countries (LDCs) group, Least developed Countries (LDCs)
League of Arab States
LMDCs: Like-Minded Developing Countries, LMDC, Like-Minded Developing Countries (LMDCs), Like-Minded Developing Countries (LMDC), Like Minded Developing Countries, Like Minded Developing Countries (LMDCs), Like Minded Developing Countries (LMDC), Like-minded Developing Countries, Like minded Developing Countries (LMDCs), Like minded Developing Countries (LMDC)
Mountain Landlocked Developing Countries: Mountainous Landlocked Developing Countries, Landlocked Mountainous Developing Countries
OECD: Organisation for Economic Co-operation and Development
OPEC
SADC: Southern African Development Community, Southern African Development Community (SADC)
SICA: Central American Integration System, CENTRAL AMERICAN INTEGRATION SYSTEM
SIDS: Small Island Developing States, Small Island Developing States (SIDS), small island developing states, small island developing states (SIDS), small islands developing States (SIDS)
UG: Umbrella Group; Umbrella Group (a fluid grouping of non-EU Annex I countries); UMBRELLA GROUP; UMBRELLA GROUP (except the US); Umbrella Group (a group of developed countries, including the US, Canada, Japan, Australia, New Zealand, Norway and Iceland)
Valdivia Group
Visegrad Group: VISEGRAD Group of central European countries
WEOG: Western Europe and Others
